NO ./textures/n.png
SO ./textures/s.png
WE ./textures/w.png
EA ./textures/e.png

F 1,1,1
C 50,80,90

111111
100101
101001
1100N1
111111